19 49 
0 0 
01111111111111111111111111111111111111111111111111
00000000000000000000000000000000000000000000000001
11111111111111111111111111111111111111111111111101
00000000000000000000000000000000000000000000000101
00000000000000000000000000000000000000000000000101
00000000000000000000000000000000000000000000000101
00000000000000000000000000000000000000000000000101
00000000000000000000000000000000000000000000000101
00000000000000000000000000000000000000000000000101
00000000000000000000000000000000000000000000000101
00000000000000000000000000000000000000000000000101
00000000111100000000000001110000000000000000000101
00000001000000000000000001001100000000000000000101
00000010000000000000000001000010000000000000000101
00000010000000000000000001000010000000000000000101
00000010000000000000000001000010000000000000000101
00000001000000000000000001000010000000000000000101
00000000111100000000000001111100000000000000000101
00000000000010000000000001000010000000000000000101
00000000000010000000000001000010000000000000000100
00000000000010000000000001000010000000000000000101
00000000000010000000000001000100000000000000000101
00000000000100000000000001001000000000000000000101
00000011111000000000000001110000000000000000000101
00000000000000000000000000000000000000000000000101
00000000000000000000000000000000000000000000000101
00000000000000000000000000000000000000000000000101
00000000000000000000000000000000000000000000000101
00000000000000000000000000000000000000000000000101
00000000000000000000000000000000000000000000000101
